%%%%%%%%
%.%   .%
% % %  %
% % %P %
%   %  %
%%%%%  %
%.    .%
%%%%%%%%