%%%%%%
%.  .%
% %% %
%.P%.%
%%%%%%