%%%%%%
%.  .%
%P   %
%.  .%
%%%%%%